111111111111111111110000000000
100000000000000000010000000000
100000000000000000010000000000
100000000000000000010000000000
100000000000000000010000000000
100000000000000000010000000000
100000000000000000010000000000
100000000000000000010000000000
111111111111111111110000000000
000000000000000000000000000000
000000000000000000000000000000
000000000000000000000000000000
000000000000000000000000000000